0  0  0  0  0  0  0  0  0  0  7  3  3  3  3  3  3  3  3  8  0  0  0  0  0  0  0  0  0  0 
0  0  0  0  0  0  0  0  0  0  2  1  1  1  1  1  1  1  1  9  0  0  0  0  0  0  0  0  0  0
0  0  0  0  0  0  0  0  0  0  2  1  1  1  1  1  1  1  1  9  0  0  0  0  0  0  0  0  0  0
0  0  0  0  0  0  0  0  0  0  2  1  1  1  1  1  1  1  1  9  0  0  0  0  0  0  0  0  0  0
0  0  0  0  0  0 14  0  0  0  2  1  1  1  1  1  1  1  1  9  0  0  0  0  0  0  0  0  0  0
0  0  0  0  0 14 14 14  0  0  2  1  1  1  1  1  1  1  1  9  0  0  0  0  0  0  0  0  0  0
0  0  0  0  0 14 14 14  0  0  2  1  1  1  1  1  1  1  1  9  0  0  0  0  0  0  0  0  0  0
0  0  0  0  0 14 14  0  0  0  2  1  1  1  1  1  1  1  1  9  0  0  0  0  0  0  0  0  0  0
0  0  0  0  0  0 14  0  0  0  2  1  1  1  1  1  1  1  1  9  0  0  0  0  0  0  0  0  0  0
0  0  0  0  0  0  0  0  0  0  5 4 4  4  4  4  4  4  4  6  0  0  0  0  0  0  0  0  0  0
0  0  0  0  0  0  0  0  0  0  0  0  0  0  0  0  0  0  0  0  0  0  0  0  0  0  0  0  0  0
0  0  0  0  0  0  0  0  0  0  0  0  0  0  0  0  0  0  0  0  0  0  0  0  0  0  0  0  0  0
0  0  0  0  0  0  0  0  0  0  7	 3  8  0  0  0  0  0  0  0  0  0  0  0  0  0  0  0  0  0 
0  0  0  0  0  0  0  0  0  0  2 11  6  0  0  0  0  0  0  0  0  0  0  0  0  0  0  0  0  0
0  0  0  0  0  0  0  0  0  0  2  9  0  0  0  0  0  0  0  0  0  0  0  0  0  0  0  0  0  0 
0  0  0  0  0  0  0  0  0  0  2  9  0  0  0  0  0  0  0  0  0  0  0  0  0  0  0  0  0  0
0  0  0  0  0  0  0  0  0  0  2  9  0  0  0  0  0  0  0  0  0  0  0  0  0  0  0  0  0  0
0  0  0  0  0  0  0  0  0  7 12  9  0  0  0  0  0  0  0  0  0  0  0  0  0  0  0  0  0  0
0  0  0  0  7  8  0  0  0  2 11  6  0  0  0  0  0  0  0  0  0  0  0  0  0  0  0  0  0  0 
3  3  3  3  12 9  0  0  0  2  9  0  0  0  0  0  0  0  0  0  0  0  0  0  0  0  0  0  0  0 
1  1  1  1  1  13 3  3  3 12  9  0  0  0  0  0  0  0  0  0  0  0  0  0  0  0  0  0  0  0
1  1  1  1  1  1  1  1  1 11  6  0  0  0  0  0  0  0  0  0  0  0  0  0  0  0  0  0  0  0
1  1  1  1  1  1  1  1  1  9  0  0  0  0  0  0  0  0  0  0  0  0  0  0  0  0  0  0  0  0
1  1  1  1  11 4  4  4  4  6  0  0  0  0  0  0  0  0  0  0  0  0  0  0  0  0  0  0  0  0
1  1  1  11 6  0  0  0  0  0  0  0  0  0  0  0  0  0  0  0  0  0  0  0  0  0  0  0  0  0
1  1  11 6  0  0  0  7  3  3  3  8  0  0  0  0  0  0  0  0  0  0  0  0  0  0  0  0  0  0
1  1  9  0  0  0  0  2  1  1  1 13  3  8  0  0  0  0  0  0  0  0  0  0  0  0  0  0  0  0
1  1  9  0  0  0  7 12  1  1  1  1  1  9  0  0  0  0  0  0  0  0  0  0  0  0  0  0  0  0
1  1  13 3  3  3 12  1  1  1  1  1  1  9  0  0  0  0  0  0  0  0  0  0  0  0  0  0  0  0
4  4  4  4  4  4  4  4  4  4  4  4  4  6  0  0  0  0  0  0  0  0  0  0  0  0  0  0  0  0