0  0  0  0  0  0  0  0  0  0  0  0	0  0  0  0  0  0  0  0  0  0  0  0	0  0  0  0  0  0
0  0  0  0  0  0  0  0  0  0  0  0	0  0  0  0  0  0  0  0  0  0  0  0	0  0  0  0  0  0
0  0  0  0  0  0  0  0  0  0  0  0	0  0  0  0  0  0  0  0  0  0  0  0	0  0  0  0  0  0
0  0  0	 0  0  7  3  3  3  3  3  3  3  3  3  3  3  3  3  3  3  3  3  3  3  3  3  8  0  0
0  0  0  0  0  2  1  1  1  1  1  1  1  1  1  1  1  1  1  1  1  1  1  1  1  1  1  9  0  0
0  0  7  3  3  12 1  1  1  1  1  1  1  1  1  1  1  1  1  1  1  1  1  1  1  1  1  9  0  0
0  0  2  1  1  1  1  1  1  1  1  1  1  1  1  1  1  1  1  1  1  1  1  1  1  1  1  9  0  0
0  0  2  1  1  1  1  1  1  1  1  1  1  1  1  1  1  11 4  4  4  4  4  4  4  4  4  6  0  0
0  0  2  1  1  1  1  1  1  1  1  1  1  1  1  1  1  9  0  0  0  0  0  0  0  0  0  0  0  0
0  0  2  1  1  1  1  1  1  1  1  1  1  1  1  1  1  9  0  0  0  0  0  0  0  0  0  0  0  0
0  0  2  1  1  1  1  1  1  1  1  1  1  1  1  1  1  9  0  0  0  0  7  3  3  3  3  8  0  0
0  0  2  1  1  1  1  1  1  1  1  1  1  1  1  1  1  9  0  0  0  0  2  1  1  1  1  9  0  0
0  0  2  1  1  1  1  11 4  4  4  4  4  4  4  4  4  6  0  0  0  0  2  1  1  1  1  9  0  0
0  0  2  1  1  1  1  9  0  0  0  0  0  0  0  0  0  0  0  0  0  0  2  1  1  1  1  9  0  0
0  0  2  1  1  1  1  9  0  0  0  0  0  0  0  0  0  0  0  0  0  0  2  1  1  1  1  9  0  0
0  0  2  1  1  1  1  9  0  0  0  0  0  0  0  0  0  0  0  0  0  0  2  1  1  1  1  9  0  0
0  0  2  1  1  1  1  9  0  0  0  0  0  0  0  0  0  0  0  0  0  0  2  1  1  1  1  9  0  0
0  0  2  1  1  1  1  9  0  0  0  0  0  0  0  0  0  0  0  0  0  0  2  1  1  1  1  9  0  0
0  0  2  1  1  1  1  9  0  0  0  0  0  0  0  0  0  0  0  0  0  0  2  1  1  1  1  9  0  0
0  0  2  1  1  1  1  13 3  3  3  3  8  0  0  0  0  7  3  3  3  3  12  1  1  1  1  9  0  0
0  0  2  1  1  1  1  1  1  1  1  1  9  0  0  0  0  2  1  1  1  1  1  1  1  1  1  9  0  0
0  0  2  1  1  1  1  1  1  1  1  1  9  0  0  0  0  2  1  1  1  1  1  1  1  1  1  9  0  0
0  0  2  1  1  1  1  1  1  1  1  1  9  0  0  0  0  2  1  1  1  1  1  1  1  1  1  9  0  0
0  0  2  1  1  1  1  1  1  1  1  1  9  0  0  0  0  2  1  1  1  1  1  1  1  1  1  9  0  0
0  0  2  1  1  1  1  1  1  1  1  1  9  0  0  0  0  2  1  1  1  1  1  1  1  1  1  9  0  0
0  0  2  1  1  1  1  1  1  1  1  1  9  0  0  0  0  2  1  1  1  1  1  1  1  1  1  9  0  0
0  0  2  1  1  1  1  1  1  1  1  1  9  0  0  0  0  2  1  1  1  1  1  1  1  1  1  9  0  0
0  0  5  4  4  4  4  4  4  4  4  4  6  0  0  0  0  5  4  4  4  4  4  4  4  4  4  6  0  0
0  0  0  0  0  0  0  0  0  0  0  0	0  0  0  0  0  0  0  0  0  0  0  0	0  0  0  0  0  0
0  0  0  0  0  0  0  0  0  0  0  0	0  0  0  0  0  0  0  0  0  0  0  0	0  0  0  0  0  0